.=.|=.|.|=.|=|=.|=.=.|=.|.|=.|
.|=|=|||..|.=....==.||==|=|..|
.==|....||=..|==.||..==.=|==..
=.|....|.==.|==..=|=|.=.==.|..
=|..==...=.|==..==||....|.=.|.
=||.=.=||=|=..|=|=|.=..||.|..|
|.=.===|||..=..||||==....|=...
|..==||=.|==|====|.==.|=|.=.|.
.=..===..=|.|||.|=..|..==..=|=
.======|||=|=.|=||=||.=.|...=.
.===|=|===.===||=.=|||=|.||==|
=|||...|==..|=.|.=..||=.=||...
=.=|=.=..=.||==||||=|=||.|==|=
||=|=...|==.=|====|==|===|||=.
|=.=||===.|||===.=.=|||||||..|
||.|==.|.|.||=||=.||=||.|||==.
.|.|..|||||=.=..=|=.==.|=||.=.
.=||.|=|..|=|===.|=|=|....|=||
=...||.=|.....=.|..|.=..==||.|
=.|=.===....=..||=|.=|=...=.|=
=|=.=||..==....|..|.=|.|..|..=
||||.|=|.==|.==..=|=|.=|==|=|.
|.|==.|||||.=|..=..=.==.|.==||
.|=|=.|..|==..|.==.|.|.|.=|..|
.==|.===||.|==.|=.=||=..|=|=|.
.|.=.|.=||==|=|=|.==|==.|=||=.
=|..|||..||.|||=....==.|||.=||
==|=|.==.==|||==..=.....====|.
=||=|=|.==|..===..===.||.==|==
|.|.|==.|.|.|===...=..==|.|..=